10.ox
.oo....oo.
o...o.....
..........
..oo..o...
...o...o..
.......o..
..........
.....oo..o
.....o....
...o......
